//MAP CONVERTED BY dmm2tgm.py THIS HEADER COMMENT PREVENTS RECONVERSION, DO NOT REMOVE
"a" = (
/turf/open/floor/plating/asteroid/icerock,
/area/icemoon/underground/explored)
"b" = (
/turf/closed/mineral/random/snow/icyrock,
/area/icemoon/underground/explored)
"e" = (
/obj/structure/spawner/nether,
/turf/open/floor/plating/asteroid/icerock/smooth,
/area/icemoon/underground/explored)
"r" = (
/turf/open/floor/plating/asteroid/icerock/smooth,
/area/icemoon/underground/explored)
"T" = (
/turf/open/floor/plating/asteroid/icerock/cracked,
/area/icemoon/underground/explored)

(1,1,1) = {"
b
b
b
b
b
b
b
b
b
b
b
b
b
b
b
"}
(2,1,1) = {"
b
b
b
b
b
b
b
b
b
b
b
b
b
b
b
"}
(3,1,1) = {"
b
b
b
b
b
a
a
a
a
a
b
b
b
b
b
"}
(4,1,1) = {"
b
b
b
a
a
a
a
a
a
r
a
a
b
b
b
"}
(5,1,1) = {"
b
b
b
a
a
a
T
a
a
a
a
a
b
b
b
"}
(6,1,1) = {"
b
b
a
a
r
a
a
a
a
a
a
a
a
b
b
"}
(7,1,1) = {"
b
b
a
T
a
a
a
T
a
a
r
a
a
b
b
"}
(8,1,1) = {"
b
b
a
a
a
a
T
e
T
a
a
a
a
b
b
"}
(9,1,1) = {"
b
b
a
a
a
a
a
T
a
a
a
a
T
b
b
"}
(10,1,1) = {"
b
b
a
a
a
a
a
a
a
r
a
a
a
b
b
"}
(11,1,1) = {"
b
b
b
a
a
a
a
a
a
a
a
a
b
b
b
"}
(12,1,1) = {"
b
b
b
r
a
a
T
a
a
a
a
a
b
b
b
"}
(13,1,1) = {"
b
b
b
b
b
a
a
a
a
r
b
b
b
b
b
"}
(14,1,1) = {"
b
b
b
b
b
b
b
b
b
b
b
b
b
b
b
"}
(15,1,1) = {"
b
b
b
b
b
b
b
b
b
b
b
b
b
b
b
"}
