//MAP CONVERTED BY dmm2tgm.py THIS HEADER COMMENT PREVENTS RECONVERSION, DO NOT REMOVE
"aF" = (
/obj/machinery/door/airlock/centcom{
	name = "Dormitories";
	req_access_txt = "150"
	},
/obj/effect/decal/cleanable/dirt,
/turf/open/floor/wood,
/area/ruin/powered)
"bF" = (
/obj/machinery/computer/mech_bay_power_console,
/obj/effect/decal/cleanable/dirt,
/turf/open/floor/plating,
/area/ruin/powered)
"ch" = (
/obj/effect/decal/cleanable/dirt,
/turf/open/floor/wood{
	icon_state = "wood-broken4"
	},
/area/ruin/powered)
"cl" = (
/obj/item/clothing/head/helmet/space/syndicate,
/obj/effect/decal/cleanable/dirt,
/turf/open/floor/plasteel,
/area/ruin/powered)
"cn" = (
/obj/structure/table,
/obj/item/toy/talking/AI,
/obj/effect/decal/cleanable/dirt,
/turf/open/floor/plasteel/dark,
/area/ruin/powered)
"dm" = (
/obj/structure/table,
/obj/effect/decal/cleanable/dirt,
/turf/open/floor/plating,
/area/ruin/powered)
"dX" = (
/obj/structure/table/wood,
/obj/structure/frame/machine,
/obj/item/stack/cable_coil/cut,
/obj/item/circuitboard/machine/chem_dispenser/drinks/beer,
/turf/open/floor/wood{
	icon_state = "wood-broken7"
	},
/area/ruin/powered)
"eu" = (
/obj/item/circuitboard/machine/mech_recharger,
/obj/structure/frame/machine,
/obj/item/stack/cable_coil/cut,
/turf/open/floor/plating,
/area/ruin/powered)
"eX" = (
/obj/machinery/door/airlock/centcom{
	name = "Air Traffic Control";
	req_access_txt = "150"
	},
/turf/open/floor/plating,
/area/ruin/powered)
"fb" = (
/obj/structure/girder,
/obj/item/stack/telecrystal,
/turf/open/floor/plating,
/area/ruin/powered)
"fL" = (
/obj/machinery/vending/cigarette,
/turf/open/floor/plasteel,
/area/ruin/powered)
"fP" = (
/obj/effect/turf_decal/stripes/line{
	dir = 9
	},
/turf/open/floor/plating,
/area/ruin/powered)
"gp" = (
/turf/template_noop,
/area/template_noop)
"gt" = (
/obj/item/clothing/mask/gas/syndicate,
/obj/item/mining_scanner,
/obj/item/pickaxe,
/obj/structure/closet/syndicate{
	desc = "Syndicate?"
	},
/obj/item/tank/internals/emergency_oxygen/engi,
/obj/item/clothing/suit/hooded/wintercoat,
/obj/effect/decal/cleanable/dirt,
/turf/open/floor/plating,
/area/ruin/powered)
"gZ" = (
/obj/structure/chair/stool,
/obj/effect/spawner/lootdrop/maintenance,
/turf/open/floor/plasteel,
/area/ruin/powered)
"ha" = (
/obj/item/reagent_containers/food/drinks/shaker,
/obj/effect/decal/cleanable/dirt,
/turf/open/floor/wood{
	icon_state = "wood-broken3"
	},
/area/ruin/powered)
"ic" = (
/obj/machinery/vending/boozeomat,
/turf/open/floor/wood,
/area/ruin/powered)
"ij" = (
/obj/effect/decal/cleanable/dirt,
/obj/effect/spawner/lootdrop/maintenance,
/turf/open/floor/wood{
	icon_state = "wood-broken3"
	},
/area/ruin/powered)
"iB" = (
/obj/structure/table,
/obj/effect/decal/cleanable/dirt,
/turf/open/floor/plasteel/dark,
/area/ruin/powered)
"iD" = (
/obj/structure/closet/cardboard/metal,
/obj/effect/decal/cleanable/dirt,
/obj/effect/spawner/lootdrop/maintenance,
/obj/effect/spawner/lootdrop/maintenance,
/obj/effect/spawner/lootdrop/maintenance,
/obj/effect/spawner/lootdrop/maintenance,
/obj/effect/spawner/lootdrop/maintenance,
/turf/open/floor/plating,
/area/ruin/powered)
"iS" = (
/obj/effect/decal/cleanable/dirt,
/obj/machinery/suit_storage_unit{
	name = "Waffle Co suit storage unit";
	department = "synd";
	state_open = 1;
	safeties = 0;
	density = 0
	},
/turf/open/floor/mineral/plastitanium/red,
/area/ruin/powered)
"iY" = (
/obj/machinery/vending/toyliberationstation,
/turf/open/floor/plasteel,
/area/ruin/powered)
"jp" = (
/obj/effect/spawner/lootdrop/maintenance/two,
/obj/structure/closet/syndicate{
	desc = "Syndicate?"
	},
/obj/item/flashlight/flare,
/obj/item/toy/crayon/spraycan,
/obj/effect/turf_decal/box/red,
/obj/effect/decal/cleanable/dirt,
/turf/open/floor/plasteel/dark,
/area/ruin/powered)
"jI" = (
/obj/structure/table/wood,
/obj/item/paicard,
/obj/effect/decal/cleanable/dirt,
/turf/open/floor/plasteel,
/area/ruin/powered)
"jX" = (
/obj/structure/table/wood,
/obj/structure/frame/machine,
/obj/item/stack/cable_coil/cut,
/obj/item/circuitboard/machine/chem_dispenser/drinks,
/turf/open/floor/wood{
	icon_state = "wood-broken7"
	},
/area/ruin/powered)
"ke" = (
/obj/structure/table/wood,
/obj/machinery/light{
	dir = 4
	},
/turf/open/floor/wood,
/area/ruin/powered)
"kj" = (
/obj/item/shard{
	icon_state = "tiny"
	},
/obj/item/shard{
	icon_state = "small";
	pixel_x = 6;
	pixel_y = 5
	},
/obj/item/stack/cable_coil/cut,
/obj/item/shard{
	pixel_x = -4;
	pixel_y = 3
	},
/obj/effect/decal/cleanable/dirt,
/turf/open/floor/wood,
/area/ruin/powered)
"kS" = (
/obj/effect/spawner/lootdrop/maintenance/two,
/obj/structure/closet/syndicate{
	desc = "Syndicate?"
	},
/obj/item/megaphone/sec{
	name = "syndicate megaphone"
	},
/obj/item/toy/sword,
/obj/item/toy/sword,
/obj/effect/turf_decal/box/red,
/obj/effect/decal/cleanable/dirt,
/turf/open/floor/plasteel/dark,
/area/ruin/powered)
"kT" = (
/obj/structure/door_assembly/door_assembly_centcom,
/turf/open/floor/plating,
/area/ruin/powered)
"lw" = (
/obj/effect/spawner/lootdrop/maintenance,
/obj/effect/decal/cleanable/dirt,
/turf/open/floor/plating,
/area/ruin/powered)
"lN" = (
/obj/effect/decal/cleanable/dirt,
/obj/structure/light_construct,
/turf/open/floor/plasteel/dark,
/area/ruin/powered)
"mc" = (
/obj/effect/decal/cleanable/dirt,
/obj/item/rack_parts,
/turf/open/floor/plating,
/area/ruin/powered)
"mz" = (
/obj/item/toy/cards/deck/syndicate{
	pixel_x = -6;
	pixel_y = 6
	},
/obj/structure/table_frame/wood,
/obj/effect/spawner/lootdrop/maintenance,
/turf/open/floor/plating,
/area/ruin/powered)
"mE" = (
/obj/effect/spawner/lootdrop/maintenance,
/turf/open/floor/plating,
/area/ruin/powered)
"ok" = (
/obj/structure/table/wood,
/obj/item/radio{
	icon_state = "radio"
	},
/turf/open/floor/wood{
	icon_state = "wood-broken6"
	},
/area/ruin/powered)
"ot" = (
/obj/structure/toilet{
	dir = 8
	},
/obj/structure/window/reinforced/tinted{
	dir = 1
	},
/obj/machinery/door/window{
	dir = 8;
	icon_state = "right";
	name = "Tactical Toilet";
	opacity = 1
	},
/turf/open/floor/plasteel/freezer,
/area/ruin/powered)
"oU" = (
/obj/effect/spawner/lootdrop/maintenance,
/obj/effect/decal/cleanable/dirt,
/turf/open/floor/plasteel/dark,
/area/ruin/powered)
"ps" = (
/obj/effect/decal/cleanable/dirt,
/obj/effect/spawner/lootdrop/maintenance,
/turf/open/floor/wood,
/area/ruin/powered)
"pW" = (
/obj/machinery/vending/tool,
/obj/effect/decal/cleanable/dirt,
/turf/open/floor/plasteel/dark,
/area/ruin/powered)
"qi" = (
/obj/structure/frame/computer,
/obj/effect/decal/cleanable/dirt,
/turf/open/floor/plasteel/dark,
/area/ruin/powered)
"qt" = (
/obj/effect/decal/cleanable/dirt,
/obj/effect/decal/cleanable/dirt,
/turf/open/floor/wood,
/area/ruin/powered)
"rv" = (
/turf/open/floor/plating/asteroid/snow/icemoon,
/area/template_noop)
"rG" = (
/turf/open/floor/plating/asteroid/snow/icemoon,
/area/icemoon/underground/explored)
"sf" = (
/obj/structure/table/wood,
/obj/item/chair/stool,
/obj/effect/gibspawner/human,
/obj/item/disk/nuclear/fake,
/turf/open/floor/plasteel,
/area/ruin/powered)
"so" = (
/obj/effect/decal/cleanable/dirt,
/obj/effect/spawner/lootdrop/maintenance,
/turf/open/floor/wood{
	icon_state = "wood-broken5"
	},
/area/ruin/powered)
"sW" = (
/obj/effect/gibspawner/human,
/obj/effect/spawner/lootdrop/maintenance,
/obj/effect/decal/cleanable/dirt,
/turf/open/floor/plasteel,
/area/ruin/powered)
"tg" = (
/obj/structure/table_frame/wood,
/obj/effect/decal/cleanable/dirt,
/turf/open/floor/wood{
	icon_state = "wood-broken5"
	},
/area/ruin/powered)
"tr" = (
/obj/machinery/washing_machine,
/obj/effect/decal/cleanable/dirt,
/turf/open/floor/plasteel/freezer,
/area/ruin/powered)
"tt" = (
/obj/item/toy/nuke,
/obj/effect/decal/cleanable/dirt,
/turf/open/floor/wood,
/area/ruin/powered)
"tP" = (
/obj/structure/frame/computer,
/obj/item/shard{
	icon_state = "tiny"
	},
/obj/item/shard{
	pixel_x = -6;
	pixel_y = -5
	},
/obj/item/shard{
	icon_state = "medium"
	},
/turf/open/floor/plasteel,
/area/ruin/powered)
"tS" = (
/obj/effect/decal/cleanable/dirt,
/obj/effect/decal/cleanable/dirt,
/turf/open/floor/plating,
/area/ruin/powered)
"ud" = (
/obj/item/kirbyplants/random,
/obj/effect/decal/cleanable/dirt,
/turf/open/floor/plasteel,
/area/ruin/powered)
"ux" = (
/obj/item/chair/stool,
/obj/effect/spawner/lootdrop/maintenance,
/obj/effect/decal/cleanable/dirt,
/turf/open/floor/plasteel/dark,
/area/ruin/powered)
"vk" = (
/obj/structure/table,
/obj/effect/decal/cleanable/dirt,
/turf/open/floor/mineral/plastitanium/red,
/area/ruin/powered)
"vw" = (
/obj/structure/bed,
/obj/item/bedsheet/syndie{
	layer = 3
	},
/turf/open/floor/wood{
	icon_state = "wood-broken7"
	},
/area/ruin/powered)
"vV" = (
/turf/closed/wall/mineral/plastitanium/nodiagonal,
/area/ruin/powered)
"wO" = (
/obj/structure/closet/syndicate{
	desc = "Syndicate?"
	},
/obj/effect/spawner/lootdrop/maintenance/two,
/turf/open/floor/plating,
/area/ruin/powered)
"xa" = (
/obj/structure/frame/computer,
/turf/open/floor/plating/airless,
/area/ruin/powered)
"xn" = (
/obj/machinery/door/airlock/external,
/obj/effect/decal/cleanable/dirt,
/turf/open/floor/plating,
/area/ruin/powered)
"xA" = (
/obj/structure/chair/office{
	dir = 1
	},
/obj/effect/decal/cleanable/dirt,
/turf/open/floor/plasteel/dark,
/area/ruin/powered)
"xB" = (
/obj/structure/closet/syndicate{
	desc = "Syndicate?"
	},
/obj/effect/decal/cleanable/dirt,
/turf/open/floor/mineral/plastitanium/red,
/area/ruin/powered)
"yO" = (
/obj/effect/decal/cleanable/dirt,
/turf/open/floor/wood{
	icon_state = "wood-broken3"
	},
/area/ruin/powered)
"yW" = (
/obj/effect/decal/cleanable/dirt,
/obj/effect/decal/cleanable/dirt,
/turf/open/floor/wood{
	icon_state = "wood-broken"
	},
/area/ruin/powered)
"zj" = (
/obj/structure/sink{
	dir = 8;
	pixel_x = 11
	},
/obj/effect/decal/cleanable/dirt,
/obj/effect/decal/cleanable/dirt,
/turf/open/floor/plating,
/area/ruin/powered)
"zI" = (
/obj/structure/frame/computer,
/turf/open/floor/plasteel/dark,
/area/ruin/powered)
"zL" = (
/obj/structure/girder,
/obj/effect/decal/cleanable/dirt,
/turf/open/floor/plating,
/area/ruin/powered)
"zU" = (
/obj/structure/mirror{
	pixel_x = 28
	},
/obj/effect/decal/cleanable/dirt,
/turf/open/floor/plasteel/freezer,
/area/ruin/powered)
"Ai" = (
/obj/machinery/button/door/indestructible{
	id = "abandonednewcopshuttle";
	name = "mission launch control";
	pixel_x = -26
	},
/obj/effect/decal/cleanable/dirt,
/obj/item/broken_bottle,
/turf/open/floor/plasteel,
/area/ruin/powered)
"AW" = (
/obj/structure/chair/stool,
/obj/effect/decal/cleanable/dirt,
/turf/open/floor/plasteel,
/area/ruin/powered)
"Bd" = (
/obj/structure/marker_beacon{
	picked_color = "Burgundy"
	},
/turf/open/floor/plating/asteroid/snow/icemoon,
/area/icemoon/underground/explored)
"Bo" = (
/obj/structure/safe,
/obj/item/gun/ballistic/automatic/pistol{
	pin = /obj/item/firing_pin/fucked
	},
/obj/structure/safe,
/obj/item/folder/black{
	desc = "A folder stamped \"Top Secret - Property of The Syndicate.\"";
	name = "folder- 'TOP SECRET'";
	icon_state = "folder_sred"
	},
/obj/item/clothing/under/syndicate/donk/maid,
/turf/open/floor/wood,
/area/ruin/powered)
"Br" = (
/obj/effect/decal/cleanable/dirt,
/obj/effect/turf_decal/stripes/line{
	dir = 10
	},
/turf/open/floor/plating,
/area/ruin/powered)
"BS" = (
/obj/effect/decal/cleanable/dirt,
/obj/effect/turf_decal/stripes/line{
	dir = 5
	},
/turf/open/floor/plating,
/area/ruin/powered)
"Cd" = (
/obj/structure/girder,
/turf/open/floor/plating,
/area/ruin/powered)
"Cs" = (
/obj/effect/decal/cleanable/dirt,
/turf/open/floor/wood,
/area/ruin/powered)
"CU" = (
/obj/effect/turf_decal/stripes/line{
	dir = 4
	},
/turf/open/floor/plating,
/area/ruin/powered)
"Di" = (
/obj/effect/decal/cleanable/dirt,
/obj/effect/spawner/lootdrop/maintenance,
/turf/open/floor/plating,
/area/ruin/powered)
"Ds" = (
/turf/closed/wall/mineral/plastitanium,
/area/ruin/powered)
"DG" = (
/obj/structure/urinal{
	pixel_y = 28
	},
/obj/effect/decal/cleanable/dirt,
/turf/open/floor/plasteel/freezer,
/area/ruin/powered)
"Ec" = (
/obj/machinery/door/poddoor/shuttledock{
	name = "Stolen Shuttle Storage"
	},
/turf/open/floor/plating,
/area/ruin/powered)
"Ez" = (
/obj/item/broken_bottle{
	pixel_x = 3;
	pixel_y = 5
	},
/obj/item/shard,
/obj/effect/decal/cleanable/dirt,
/turf/open/floor/plasteel,
/area/ruin/powered)
"EV" = (
/obj/machinery/light/small{
	brightness = 3;
	dir = 8
	},
/obj/effect/decal/cleanable/dirt,
/turf/open/floor/plasteel/freezer,
/area/ruin/powered)
"Fb" = (
/obj/structure/closet/syndicate{
	desc = "Syndicate?"
	},
/obj/item/clothing/shoes/jackboots,
/obj/item/clothing/glasses/night,
/obj/item/radio/headset,
/obj/item/kitchen/knife/combat/survival,
/obj/item/radio{
	icon_state = "radio"
	},
/obj/effect/decal/cleanable/dirt,
/obj/item/clothing/under/syndicate/waffle,
/turf/open/floor/wood,
/area/ruin/powered)
"Fh" = (
/obj/machinery/door/airlock/centcom{
	name = "Auxiliary Dock";
	req_access_txt = ""
	},
/turf/open/floor/plating,
/area/ruin/powered)
"Fo" = (
/obj/effect/decal/cleanable/dirt,
/obj/effect/turf_decal/stripes/line{
	dir = 8
	},
/turf/open/floor/plating,
/area/ruin/powered)
"Fr" = (
/turf/closed/indestructible/opsglass,
/area/ruin/powered)
"FL" = (
/obj/structure/flora/bush,
/turf/open/floor/plating/asteroid/snow/icemoon,
/area/icemoon/underground/explored)
"GU" = (
/obj/item/paper/fluff/stations/centcom/disk_memo,
/obj/effect/spawner/lootdrop/maintenance,
/obj/effect/decal/cleanable/dirt,
/turf/open/floor/plasteel,
/area/ruin/powered)
"Ha" = (
/obj/effect/turf_decal/stripes/line{
	dir = 6
	},
/turf/open/floor/plating,
/area/ruin/powered)
"Hy" = (
/obj/machinery/light{
	dir = 8
	},
/obj/effect/decal/cleanable/dirt,
/turf/open/floor/plasteel,
/area/ruin/powered)
"HB" = (
/obj/effect/decal/cleanable/dirt,
/obj/effect/gibspawner/human,
/turf/open/floor/plasteel,
/area/ruin/powered)
"IG" = (
/obj/effect/decal/cleanable/dirt,
/obj/effect/turf_decal/stripes/line,
/turf/open/floor/plating,
/area/ruin/powered)
"Je" = (
/obj/effect/decal/cleanable/dirt,
/turf/open/floor/plasteel,
/area/ruin/powered)
"JE" = (
/obj/effect/decal/cleanable/dirt,
/turf/open/floor/wood{
	icon_state = "wood-broken6"
	},
/area/ruin/powered)
"JN" = (
/obj/structure/closet/syndicate{
	desc = "Syndicate?"
	},
/obj/effect/decal/cleanable/dirt,
/obj/effect/spawner/lootdrop/maintenance/two,
/turf/open/floor/mineral/plastitanium/red,
/area/ruin/powered)
"Kk" = (
/obj/structure/closet/syndicate{
	desc = "Syndicate?"
	},
/obj/effect/decal/cleanable/dirt,
/obj/effect/spawner/lootdrop/maintenance/two,
/obj/item/ammo_box/magazine/m10mm,
/turf/open/floor/mineral/plastitanium/red,
/area/ruin/powered)
"Ko" = (
/obj/effect/turf_decal/stripes/line{
	dir = 8
	},
/turf/open/floor/plating,
/area/ruin/powered)
"Kx" = (
/obj/item/soap/syndie,
/obj/machinery/light/small{
	dir = 1
	},
/obj/effect/decal/cleanable/dirt,
/turf/open/floor/plating,
/area/ruin/powered)
"KJ" = (
/obj/effect/decal/cleanable/dirt,
/obj/effect/turf_decal/stripes/line{
	dir = 4
	},
/turf/open/floor/plating,
/area/ruin/powered)
"KN" = (
/obj/structure/table/wood,
/obj/item/toy/plush/nukeplushie,
/obj/effect/decal/cleanable/dirt,
/turf/open/floor/wood,
/area/ruin/powered)
"KZ" = (
/obj/effect/decal/cleanable/dirt,
/obj/effect/spawner/lootdrop/maintenance,
/turf/open/floor/plasteel,
/area/ruin/powered)
"Lh" = (
/obj/item/bedsheet/syndie,
/obj/structure/bed,
/obj/effect/decal/cleanable/dirt,
/turf/open/floor/wood,
/area/ruin/powered)
"Lq" = (
/obj/machinery/door/poddoor/shuttledock,
/obj/structure/fans/tiny,
/turf/open/floor/plating,
/area/ruin/powered)
"Lt" = (
/obj/structure/light_construct,
/obj/effect/decal/cleanable/dirt,
/turf/open/floor/wood{
	icon_state = "wood-broken"
	},
/area/ruin/powered)
"LA" = (
/obj/structure/rack,
/obj/item/clothing/suit/space/syndicate,
/turf/open/floor/mineral/plastitanium/red,
/area/ruin/powered)
"LL" = (
/obj/effect/decal/cleanable/dirt,
/obj/effect/spawner/lootdrop/maintenance,
/turf/open/floor/plasteel/dark,
/area/ruin/powered)
"LP" = (
/obj/effect/decal/cleanable/dirt,
/turf/open/floor/plating,
/area/ruin/powered)
"LU" = (
/turf/open/floor/plasteel,
/area/ruin/powered)
"Ml" = (
/obj/structure/closet/syndicate{
	desc = "Syndicate?"
	},
/obj/item/toy/figure/syndie,
/obj/effect/decal/cleanable/dirt,
/turf/open/floor/plating,
/area/ruin/powered)
"PH" = (
/obj/machinery/door/airlock/centcom{
	name = "Dormitories";
	req_access_txt = "150"
	},
/obj/effect/decal/cleanable/dirt,
/obj/effect/decal/cleanable/dirt,
/turf/open/floor/wood{
	icon_state = "wood-broken4"
	},
/area/ruin/powered)
"Qb" = (
/obj/structure/closet/syndicate{
	desc = "Syndicate?"
	},
/obj/item/tank/internals/emergency_oxygen/engi,
/obj/item/clothing/suit/hooded/wintercoat,
/turf/open/floor/plating,
/area/ruin/powered)
"Qf" = (
/obj/item/chair/stool,
/obj/effect/decal/cleanable/dirt,
/turf/open/floor/plasteel,
/area/ruin/powered)
"QT" = (
/obj/machinery/vending/coffee,
/turf/open/floor/plasteel,
/area/ruin/powered)
"Rj" = (
/obj/machinery/door/poddoor/shutters{
	id = "abandonednewcopshuttle";
	name = "Shuttle Dock"
	},
/turf/open/floor/plating,
/area/ruin/powered)
"Ro" = (
/obj/structure/table/wood,
/turf/open/floor/wood,
/area/ruin/powered)
"Rx" = (
/obj/machinery/door/airlock/centcom{
	name = "Dormitories";
	req_access_txt = "150"
	},
/obj/effect/decal/cleanable/dirt,
/turf/open/floor/wood{
	icon_state = "wood-broken5"
	},
/area/ruin/powered)
"Si" = (
/obj/structure/table/wood,
/obj/item/storage/box/drinkingglasses,
/obj/item/shard{
	icon_state = "small"
	},
/turf/open/floor/wood,
/area/ruin/powered)
"Ss" = (
/obj/machinery/light{
	dir = 1
	},
/obj/effect/decal/cleanable/dirt,
/obj/effect/turf_decal/stripes/line,
/turf/open/floor/plating,
/area/ruin/powered)
"SN" = (
/obj/structure/table/wood,
/obj/machinery/light{
	dir = 8
	},
/turf/open/floor/wood{
	icon_state = "wood-broken6"
	},
/area/ruin/powered)
"SQ" = (
/obj/machinery/vending/cola,
/turf/open/floor/plating,
/area/ruin/powered)
"Uf" = (
/obj/item/bedsheet/syndie,
/obj/structure/bed,
/turf/open/floor/wood{
	icon_state = "wood-broken7"
	},
/area/ruin/powered)
"Ut" = (
/obj/item/chair/stool,
/obj/effect/decal/cleanable/dirt,
/turf/open/floor/plating,
/area/ruin/powered)
"VK" = (
/obj/structure/table/wood,
/obj/item/chair/stool,
/obj/item/camera{
	pixel_x = -2
	},
/turf/open/floor/wood,
/area/ruin/powered)
"VM" = (
/obj/effect/turf_decal/stripes/line,
/turf/open/floor/plating,
/area/ruin/powered)
"VT" = (
/obj/structure/bed/dogbed/cayenne,
/obj/effect/decal/cleanable/dirt,
/turf/open/floor/plasteel,
/area/ruin/powered)
"Wp" = (
/obj/effect/decal/cleanable/dirt,
/mob/living/simple_animal/hostile/syndicate/ranged/shotgun/space,
/turf/open/floor/plasteel/freezer,
/area/ruin/powered)
"Ws" = (
/obj/item/clothing/mask/gas/syndicate,
/obj/item/mining_scanner,
/obj/item/pickaxe,
/obj/structure/closet/syndicate{
	desc = "Syndicate?"
	},
/obj/item/tank/internals/emergency_oxygen/engi,
/obj/item/clothing/suit/hooded/wintercoat,
/obj/effect/decal/cleanable/dirt,
/obj/machinery/light{
	dir = 1
	},
/turf/open/floor/plasteel/dark,
/area/ruin/powered)
"Wt" = (
/turf/open/floor/plating,
/area/ruin/powered)
"WE" = (
/obj/machinery/door/airlock/centcom{
	name = "Dormitories";
	req_access_txt = "150"
	},
/turf/open/floor/plating,
/area/ruin/powered)
"WI" = (
/obj/effect/decal/cleanable/dirt,
/turf/open/floor/wood{
	icon_state = "wood-broken"
	},
/area/ruin/powered)
"WM" = (
/obj/machinery/door/airlock/external,
/turf/open/floor/plating,
/area/ruin/powered)
"WV" = (
/obj/structure/flora/grass/both,
/turf/open/floor/plating/asteroid/snow/icemoon,
/area/icemoon/underground/explored)
"WW" = (
/obj/effect/decal/cleanable/dirt,
/obj/effect/decal/cleanable/dirt,
/obj/effect/spawner/lootdrop/maintenance,
/turf/open/floor/wood,
/area/ruin/powered)
"Xk" = (
/obj/structure/light_construct{
	dir = 4
	},
/obj/effect/decal/cleanable/dirt,
/turf/open/floor/plasteel,
/area/ruin/powered)
"Xn" = (
/obj/structure/flora/tree/pine,
/turf/open/floor/plating/asteroid/snow/icemoon,
/area/icemoon/underground/explored)
"XN" = (
/obj/machinery/light,
/obj/effect/decal/cleanable/dirt,
/turf/open/floor/plating,
/area/ruin/powered)
"YJ" = (
/obj/machinery/door/airlock/centcom{
	name = "Restroom";
	req_access_txt = "150"
	},
/turf/open/floor/plasteel,
/area/ruin/powered)
"YU" = (
/obj/structure/mecha_wreckage/mauler{
	self_destruct = 0
	},
/obj/machinery/light{
	dir = 1
	},
/turf/open/floor/plating{
	icon_state = "platingdmg1"
	},
/area/ruin/powered)
"Zc" = (
/obj/structure/closet/cardboard,
/obj/effect/spawner/lootdrop/maintenance,
/obj/effect/spawner/lootdrop/maintenance,
/obj/effect/spawner/lootdrop/maintenance,
/obj/effect/spawner/lootdrop/maintenance,
/obj/effect/spawner/lootdrop/maintenance,
/turf/open/floor/plating,
/area/ruin/powered)
"Zk" = (
/obj/item/bedsheet/syndie,
/obj/structure/bed,
/turf/open/floor/wood,
/area/ruin/powered)
"ZL" = (
/obj/machinery/door/airlock/centcom{
	name = "EVA Equipment";
	req_access_txt = "150"
	},
/turf/open/floor/plating,
/area/ruin/powered)
"ZN" = (
/obj/machinery/light,
/obj/effect/decal/cleanable/dirt,
/turf/open/floor/plasteel,
/area/ruin/powered)
"ZU" = (
/obj/effect/decal/cleanable/dirt,
/turf/open/floor/plasteel/dark,
/area/ruin/powered)
"ZZ" = (
/obj/structure/table/wood,
/obj/item/storage/crayons{
	pixel_x = -2;
	pixel_y = 5
	},
/obj/item/storage/crayons{
	pixel_x = 2;
	pixel_y = 5
	},
/obj/item/pizzabox/bomb,
/turf/open/floor/plasteel,
/area/ruin/powered)

(1,1,1) = {"
gp
gp
gp
gp
gp
gp
gp
gp
gp
Bd
rG
Bd
rG
Bd
rG
Bd
rG
Bd
rG
Bd
rG
Bd
rG
Bd
rG
Bd
gp
gp
gp
gp
gp
gp
"}
(2,1,1) = {"
gp
gp
gp
gp
gp
gp
gp
gp
gp
rG
rG
rG
rG
rG
rG
rG
rG
rG
rG
rG
rG
rG
rG
rG
rG
rG
gp
gp
gp
gp
gp
gp
"}
(3,1,1) = {"
gp
gp
gp
gp
gp
gp
gp
gp
gp
Bd
rG
rG
rG
rG
rG
rG
rG
rG
rG
rG
rG
rG
rG
rG
rG
Bd
gp
gp
gp
gp
gp
gp
"}
(4,1,1) = {"
gp
gp
gp
gp
gp
gp
gp
gp
gp
rG
rG
rG
rG
rG
rG
rG
rG
rG
rG
rG
rG
rG
rG
rG
rG
rG
gp
gp
gp
gp
gp
gp
"}
(5,1,1) = {"
gp
gp
gp
gp
gp
gp
gp
gp
gp
Bd
rG
rG
rG
rG
rG
rG
rG
rG
rG
rG
rG
rG
rG
rG
rG
Bd
gp
gp
gp
gp
gp
gp
"}
(6,1,1) = {"
gp
gp
gp
gp
gp
gp
gp
gp
gp
rG
rG
rG
rG
rG
rG
rG
rG
rG
rG
rG
rG
rG
rG
rG
rG
rG
gp
gp
gp
gp
gp
gp
"}
(7,1,1) = {"
gp
gp
gp
gp
gp
gp
gp
gp
gp
Bd
rG
rG
rG
rG
rG
rG
rG
rG
rG
rG
rG
rG
rG
rG
rG
Bd
gp
gp
gp
gp
gp
gp
"}
(8,1,1) = {"
gp
gp
gp
gp
gp
gp
gp
gp
gp
rG
rG
rG
rG
rG
rG
rG
rG
rG
rG
rG
rG
rG
rG
rG
rG
rG
rG
gp
gp
gp
gp
gp
"}
(9,1,1) = {"
gp
gp
gp
gp
gp
gp
rG
rG
rG
Bd
rG
Bd
rG
Bd
rG
Bd
rG
Bd
rG
Bd
rG
Bd
rG
Bd
rG
Bd
rG
rG
gp
gp
gp
gp
"}
(10,1,1) = {"
gp
gp
rG
rG
Xn
rG
FL
rG
WV
rG
rG
rG
rG
WV
rG
rG
rG
vV
xn
vV
rG
Xn
WV
rG
rG
rG
Xn
rG
gp
gp
gp
gp
"}
(11,1,1) = {"
vV
vV
vV
vV
rG
rG
rG
rG
rG
rG
FL
rG
rG
rG
rG
WV
rG
Fr
LP
Fr
rG
rG
rG
rG
WV
rG
rG
rG
rG
gp
gp
gp
"}
(12,1,1) = {"
Ec
LP
LP
vV
rG
rG
rG
WV
WV
rG
Xn
rG
rG
Xn
rG
rG
rG
vV
WM
vV
rG
rG
rG
rG
rG
rG
rG
WV
rG
gp
gp
gp
"}
(13,1,1) = {"
Ec
LP
lw
vV
FL
FL
rG
rG
rG
rG
rG
rG
rG
vV
vV
vV
vV
vV
Rj
vV
vV
vV
vV
Xn
rG
rG
WV
rG
rG
gp
gp
gp
"}
(14,1,1) = {"
Ec
LP
LP
vV
rG
rG
rG
rG
rG
WV
rG
FL
vV
vV
tP
Ut
Hy
LU
LP
Ai
Si
Lt
vV
vV
vV
Fr
vV
vV
Xn
gp
gp
gp
"}
(15,1,1) = {"
Ec
LP
XN
vV
rG
rG
rG
Xn
rG
rG
rG
rG
Fr
fL
LP
Je
mE
AW
LP
AW
KN
ha
tg
vV
iS
mc
LA
vV
rG
gp
gp
gp
"}
(16,1,1) = {"
Ec
lw
LP
vV
rG
Xn
rG
rG
rG
rG
rG
rG
Fr
lw
LP
AW
jI
sf
Je
Ut
tg
Cs
ic
vV
Qb
ZU
ZU
vV
rG
gp
gp
gp
"}
(17,1,1) = {"
Ec
LP
LP
Cd
vV
Fr
Fr
Fr
vV
vV
vV
vV
Cd
Je
GU
LP
ZZ
mz
Ez
gZ
ok
tt
jX
vV
Ws
lw
LP
vV
rG
gp
gp
gp
"}
(18,1,1) = {"
Ec
lw
LP
LP
LP
LP
LP
LP
LP
LP
LP
Wt
Fh
Xk
lw
Je
Je
cl
Wt
VT
VK
kj
dX
vV
gt
LP
LL
vV
WV
gp
gp
gp
"}
(19,1,1) = {"
Ec
LP
LP
vV
vV
Fr
Fr
Fr
vV
Cd
vV
vV
vV
Cd
QT
sW
LP
Qf
Je
Je
LP
Je
vV
vV
Fr
ZL
Cd
vV
rG
rG
gp
gp
"}
(20,1,1) = {"
Ec
LP
LP
vV
rG
WV
rG
Xn
rG
WV
rG
rG
WV
vV
SQ
KZ
Je
iY
LP
Je
lw
HB
kT
ZU
LP
ZU
xB
vV
rG
Xn
gp
gp
"}
(21,1,1) = {"
Ec
Di
XN
vV
rG
Xn
rG
rG
rG
rG
rG
Xn
rG
vV
vV
Cd
YJ
vV
Cd
ud
Je
ZN
vV
LP
oU
ZU
Ml
Fr
rG
rG
gp
gp
"}
(22,1,1) = {"
Ec
LP
LP
vV
rG
rG
Xn
rG
rG
WV
rG
rG
rG
vV
Ds
DG
LP
EV
vV
vV
WM
vV
vV
eu
LP
LP
Kk
Fr
rG
rG
gp
gp
"}
(23,1,1) = {"
Ec
LP
LP
vV
WV
rG
rG
WV
rG
rG
Xn
rG
rG
vV
Kx
tS
Wp
ot
Cd
vV
Wt
vV
vV
YU
LL
ZU
JN
Fr
rG
rG
gp
gp
"}
(24,1,1) = {"
Ec
LP
LP
vV
rG
Xn
rG
rG
Xn
rG
rG
Xn
WV
Fr
tr
zU
zj
vV
Cd
vV
LP
vV
vV
bF
oU
LP
wO
Fr
rG
WV
gp
gp
"}
(25,1,1) = {"
vV
vV
vV
vV
rG
rG
WV
rG
rG
WV
rG
rG
rG
vV
vV
vV
vV
fb
vV
vV
Di
vV
vV
pW
Di
ux
vk
vV
rG
Xn
gp
gp
"}
(26,1,1) = {"
gp
gp
gp
gp
rG
rG
rG
Xn
rG
rG
Xn
rG
rG
rG
rG
vV
vV
vV
Cd
vV
Wt
vV
vV
vV
vV
vV
Cd
vV
vV
vV
vV
vV
"}
(27,1,1) = {"
gp
gp
gp
gp
gp
rG
rG
rG
WV
rG
rG
rG
Xn
rG
rG
vV
Wt
LP
Wt
vV
Wt
vV
Wt
Wt
LP
vV
Uf
yO
Cd
yW
Lh
vV
"}
(28,1,1) = {"
gp
gp
gp
gp
gp
gp
rv
Xn
rG
rG
rG
Xn
rG
rG
Xn
vV
LP
Zc
KJ
vV
WM
vV
CU
iD
LP
vV
ke
Cs
vV
Cs
Bo
vV
"}
(29,1,1) = {"
gp
gp
gp
gp
gp
gp
gp
rG
rG
WV
rG
rG
rG
rG
rG
vV
LP
Ha
LP
Wt
mE
Wt
Wt
BS
Wt
vV
Ds
PH
vV
aF
vV
vV
"}
(30,1,1) = {"
gp
gp
gp
gp
gp
gp
gp
gp
rG
rG
Xn
rG
WV
rG
rG
vV
IG
LP
LP
LP
LP
LP
LP
VM
LP
WE
WW
ps
ij
ch
Fb
Fr
"}
(31,1,1) = {"
gp
gp
gp
gp
gp
gp
gp
gp
vV
vV
Fr
Fr
Fr
vV
vV
vV
Ss
lw
Wt
Di
LP
LP
lw
IG
XN
vV
qt
so
Cs
ps
Fb
Fr
"}
(32,1,1) = {"
gp
gp
gp
gp
gp
gp
gp
gp
Fr
cn
dm
jp
ZU
LP
Wt
Cd
IG
LP
LP
LP
LP
LP
LP
IG
LP
Cd
zL
aF
zL
Rx
vV
vV
"}
(33,1,1) = {"
gp
gp
gp
gp
gp
gp
gp
gp
Fr
zI
xA
LP
ZU
lw
ZU
Cd
IG
LP
LP
LP
lw
LP
Wt
VM
mE
vV
Ro
WI
vV
Cs
SN
vV
"}
(34,1,1) = {"
gp
gp
gp
gp
gp
gp
gp
gp
Fr
xa
Di
ZU
LP
ZU
LP
eX
IG
LP
mE
LP
LP
LP
LP
VM
Wt
Cd
Zk
Cs
vV
JE
vw
vV
"}
(35,1,1) = {"
gp
gp
gp
gp
gp
gp
gp
gp
Fr
qi
xA
ZU
LP
ZU
lN
vV
Di
Br
LP
LP
LP
LP
mE
fP
Wt
vV
vV
vV
vV
vV
vV
vV
"}
(36,1,1) = {"
gp
gp
gp
gp
gp
gp
gp
gp
Fr
iB
dm
kS
ZU
LP
LP
vV
LP
LP
Fo
Ko
Fo
Ko
Ko
Wt
LP
vV
gp
gp
gp
gp
gp
gp
"}
(37,1,1) = {"
gp
gp
gp
gp
gp
gp
gp
gp
vV
vV
Fr
Fr
Fr
vV
vV
vV
Lq
Lq
Lq
Lq
Lq
Lq
Lq
Lq
Lq
vV
gp
gp
gp
gp
gp
gp
"}
